1	1	1	1	1	1	1	1	1	1	1	1	1	1	1	1	1	1	1	1
1	2	2	2	2	2	2	2	1	2	2	2	1	2	2	2	2	2	2	1
1	2	1	1	2	1	1	2	2	2	1	2	1	2	1	2	1	1	2	1
1	2	1	1	2	1	1	2	1	2	1	2	1	2	1	2	1	1	2	1
1	2	1	2	2	2	2	2	2	2	1	2	2	2	1	2	2	2	2	1
1	2	1	2	1	1	2	2	1	2	1	2	1	1	1	2	1	3	1	1
1	2	3	2	1	2	2	2	2	2	2	2	2	2	2	2	1	2	1	1
1	2	1	1	1	2	1	2	1	1	4	1	1	2	1	2	2	2	2	1
1	2	2	2	2	2	2	2	1	1	8	1	1	2	1	2	1	1	2	1
1	1	2	1	2	1	1	2	1	5	6	7	1	2	1	2	1	1	2	1
1	1	2	1	2	1	1	2	1	1	1	1	1	2	2	2	1	1	2	1
1	1	2	1	2	1	1	2	1	2	2	2	1	2	1	2	2	2	2	1
1	2	2	1	2	2	2	2	2	2	1	2	2	2	1	1	1	1	2	1
1	2	1	1	1	1	1	2	1	1	1	1	1	2	2	2	2	2	2	1
1	2	2	2	2	2	2	2	2	2	1	2	2	2	1	2	1	1	2	1
1	2	1	1	1	2	1	1	1	2	1	2	1	1	1	2	1	1	2	1
1	2	2	2	1	3	2	2	2	2	9	2	2	2	1	2	2	2	2	1
1	2	1	2	1	2	1	2	1	2	1	1	1	2	2	3	1	1	2	1
1	2	1	2	1	2	1	2	1	2	1	2	2	2	1	2	2	2	2	1
1	1	1	1	1	1	1	1	1	1	1	1	1	1	1	1	1	1	1	1
